
||||||||||||||||||||||||||||
.....||..............||.....
||||.||.||||||||||||.||.||||
___|.||.||||||||||||.||.|___
___|....||........||....|___
___|.||.||.||||||.||.||.|___
||||.||....|____|....||.||||
.....||.||.||||||.||.||.....
|.||.||.||........||.||.||.|
|.||.||.||||||||||||.||.||.|
|.||.||.||||||||||||.||.||.|
|..........................|
|.|||||||.||||||||.|||||||.|
|.|||||||.|______|.|||||||.|
|.||......|______|......||.|
|.||.||||.|______|.||||.||.|
|....||||.||||||||.||||....|
|||||||..............|||||||
|||||||.||||||||||||.|||||||
|.......||||||||||||.......|
|.|||.||||........||||.|||.|
|.|||.||||.||||||.||||.|||.|
|.......||.||||||.||.......|
|||||||.||........||.|||||||
|||||||.||.||||||.||.|||||||
|....||.||.||||||.||.||....|
|.||.||.||........||.||.||.|
|.||....||.||||||.||....||.|
|.||.||.||.||||||.||.||.||.|
|....||..............||....|
||||||||||||||||||||||||||||

||||||||||||||||||||||||||||
|.........||....||.........|
|.||.||||.||.||.||.||||.||.|
|.||.||||....||....||||.||.|
|.||...||.||||||||.||...||.|
|.||||.||.||||||||.||.||||.|
|.||||.||.||....||.||.||||.|
|.........||.||.||.........|
||||.||||.||.||.||.||||.||||
||||.|__|.||.||.||.|__|.||||
..||.||||.||.||.||.||||.||..
|.||....................||.|
|.||.||||.||||||||.||||.||.|
|.||.||||.|______|.||||.||.|
|.........|______|.........|
|||||||||.|______|.|||||||||
|||||||||.||||||||.|||||||||
..||....................||..
|.||.||.||||.||.||||.||.||.|
|.||.||.||||.||.||||.||.||.|
|....||...||.||.||...||....|
|||||||||.||.||.||.|||||||||
|||||||||.||.||.||.|||||||||
|.........||....||.........|
|.|||||.||||.||.||||.|||||.|
|.|___|.||||.||.||||.|___|.|
|.|___|......||......|___|.|
|.|___|.||||||||||||.|___|.|
|.|||||.||||||||||||.|||||.|
|..........................|
||||||||||||||||||||||||||||

||||||||||||||||||||||||||||
||.......||||||||||.......||
||.||.||.||......||.||.||.||
||.||.||.||.||||.||.||.||.||
||.||.||.||.||||.||.||.||.||
||....||............||....||
|||||.||.||||||||||.||.|||||
|||||.||.||||||||||.||.|||||
||....||............||....||
||.||.|||||.||||.|||||.||.||
||.||.|||||.||||.|||||.||.||
||.||..................||.||
||.||.|||.||||||||.|||.||.||
||.||.|||.||||||||.|||.||.||
||.||.....||||||||.....||.||
||.||.|||.||||||||.|||.||.||
||.||.|||.||||||||.|||.||.||
||.||..................||.||
||.||.||||||.||.||||||.||.||
||....||||||.||.||||||....||
|||||.||.....||.....||.|||||
|||||.||.||||||||||.||.|||||
||....||.||||||||||.||....||
||.||.||.||......||.||.||.||
||.||....||.||||.||....||.||
||.||.||.||.||||.||.||.||.||
||.||.||............||.||.||
||.||.|||||.||||.|||||.||.||
||.||.|||||.||||.|||||.||.||
||........................||
||||||||||||||||||||||||||||

||||||||||||||||||||||||||||
||||||||||||||||||||||||||||
|.......||........||.......|
|.||.||.||.||||||.||.||.||.|
|.||.||.||.||||||.||.||.||.|
|.||.||.||........||.||.||.|
|.||.||.||.||||||.||.||.||.|
|.||.||.||.||||||.||.||.||.|
|.......||...||...||.......|
|.||||||||||.||.||||||||||.|
|.||||||||||.||.||||||||||.|
|..........................|
|||||.|||.||||||||.|||.|||||
|||||.|||.||||||||.|||.|||||
|.........||||||||.........|
|.|||||||.||||||||.|||||||.|
|.|||||||.||||||||.|||||||.|
|.||....................||.|
|.||.||.||||.||.||||.||.||.|
|....||.||||.||.||||.||....|
|.||.||.||...||...||.||.||.|
|.||.||.||.||||||.||.||.||.|
|.||.||.||.||||||.||.||.||.|
|.......||........||.......|
||||.|||||.||||||.|||||.||||
||||.|||||.||||||.|||||.||||
||...........||...........||
||.|||||||||.||.|||||||||.||
||.|||||||||.||.|||||||||.||
||...........||...........||
||||||||||||||||||||||||||||

||||||||||||||||||||||||||||
|.........||....||.........|
|.||||.||.||.||.||.||.||||.|
|.||||.||....||....||.||||.|
|......||.||||||||.||......|
|.||||.||.||||||||.||.||||.|
|.||||.......||.......||||.|
|...|||||.||.||.||.|||||...|
|||.|||||.||....||.|||||.|||
|||.||....||||||||....||.|||
|...||.||.||||||||.||.||...|
|.||||.||..........||.||||.|
|.||||.||.||||||||.||.||||.|
|.........||||||||.........|
|.||||.||.||||||||.||.||||.|
|.||||.||.||||||||.||.||||.|
|.||...||.||||||||.||...||.|
|.||.||||..........||||.||.|
|.||.||||.||.||.||.||||.||.|
|.........||.||.||.........|
||||.||||.||.||.||.||||.||||
||||.||||.||.||.||.||||.||||
|.........||.||.||.........|
|.|||||.||||....||||.|||||.|
|.|||||.||||.||.||||.|||||.|
|............||............|
|.||.||.||||.||.||||.||.||.|
|.||.||.||||.||.||||.||.||.|
|.||.||..............||.||.|
|....||||||||||||||||||....|
||||||||||||||||||||||||||||

||||||||||||||||||||||||||||
|............||............|
|.||.||.||||.||.||||.||.||.|
|.||.||.||||.||.||||.||.||.|
|.||.||..............||.||.|
|....||||.||||||||.||||....|
|.||.||||.||||||||.||||.||.|
|.||...||..........||...||.|
|.||||.||.||.||.||.||.||||.|
|.||||.||.||.||.||.||.||||.|
|......||.||.||.||.||......|
|||.||.||..........||.||.|||
|||.||.||.||||||||.||.||.|||
|...||.||.||||||||.||.||...|
|.||||....||||||||....||||.|
|.||||.||.||||||||.||.||||.|
|...||.||.||||||||.||.||...|
|||.||.||..........||.||.|||
|||.||.||.||||||||.||.||.|||
|......||.||||||||.||......|
|.|||||||..........|||||||.|
|.|||||||.||||||||.|||||||.|
|.........||||||||.........|
|||||||.||||....||||.|||||||
|||||||.||||.||.||||.|||||||
||...........||...........||
||.||||.||.||||||.||.||||.||
||.||||.||.||||||.||.||||.||
||......||........||......||
||||||||||||||||||||||||||||
||||||||||||||||||||||||||||

||||||||||||||||||||||||||||
|..........................|
|.|||.|||.||||||||.|||.|||.|
|.|||.|||.||||||||.|||.|||.|
|..........................|
|.|||||.||||||||||||.|||||.|
|.|||||.||||||||||||.|||||.|
|....||..............||....|
|.||.||||.||.||.||.||||.||.|
|.||.||||.||.||.||.||||.||.|
|.||...||.||.||.||.||...||.|
|.||||.||..........||.||||.|
|.||||.||.||||||||.||.||||.|
|.........||||||||.........|
|.||.||||.||||||||.||||.||.|
|.||.||||.||||||||.||||.||.|
|.||...||.||||||||.||...||.|
|.||||.||..........||.||||.|
|.||||.||.||.||.||.||.||||.|
|......||.||.||.||.||......|
|.||||.||.||.||.||.||.||||.|
|.||||....||.||.||....||||.|
|...|||||.||.||.||.|||||...|
|||.|||||.||....||.|||||.|||
|||.||....||||||||....||.|||
|...||.||.||||||||.||.||...|
|.||||.||....||....||.||||.|
|.||||.||.||.||.||.||.||||.|
|.........||.||.||.........|
||||||||||||....||||||||||||
||||||||||||||||||||||||||||

||||||||||||||||||||||||||||
||||||||||||||||||||||||||||
|....||......||......||....|
|.||.||.||||.||.||||.||.||.|
|.||.||.||||.||.||||.||.||.|
|.||.||.||........||.||.||.|
|.......||.||||||.||.......|
|.||.|||||.||||||.|||||.||.|
|.||.|||||...||...|||||.||.|
|.||....||||.||.||||....||.|
|.||.||.||||.||.||||.||.||.|
|.||.||..............||.||.|
|.||.||||.||||||||.||||.||.|
|.||.||||.||||||||.||||.||.|
|.........||||||||.........|
|.||.||||.||||||||.||||.||.|
|.||.||||.||||||||.||||.||.|
|.||....................||.|
|.||||.||||.||||.||||.||||.|
|.||||.||||.||||.||||.||||.|
|........||......||........|
|||.||||.||.||||.||.||||.|||
|||.||||.||.||||.||.||||.|||
|.....||............||.....|
|.|||.|||||.||||.|||||.|||.|
|.|||.|||||.||||.|||||.|||.|
|..........................|
|.|||||||||.||||.|||||||||.|
|.|||||||||.||||.|||||||||.|
|..........................|
||||||||||||||||||||||||||||

||||||||||||||||||||||||||||
||||||||||||||||||||||||||||
|..........................|
|.||||.||||||||||||||.||||.|
|.||||.||||||||||||||.||||.|
|...||.......||.......||...|
|||.|||||.||.||.||.|||||.|||
|||.|||||.||.||.||.|||||.|||
|.........||....||.........|
|.|||.|||.||||||||.|||.|||.|
|.|||.|||.||||||||.|||.|||.|
|..........................|
|||||.|||.||||||||.|||.|||||
|||||.|||.||||||||.|||.|||||
||........||||||||........||
||.||.|||.||||||||.|||.||.||
||.||.|||.||||||||.|||.||.||
||.||..................||.||
||.||||||.||||||||.||||||.||
||.||||||.||||||||.||||||.||
||........................||
||.||||||.||||||||.||||||.||
||.||||||.||||||||.||||||.||
||...||..............||...||
||||.||.||||.||.||||.||.||||
||||.||.||||.||.||||.||.||||
|.......||...||...||.......|
|.||||||||.||||||.||||||||.|
|.||||||||.||||||.||||||||.|
|..........................|
||||||||||||||||||||||||||||

